chrom	start	end	size	sample	clusters
chr01	0	250000	250000	2x_LOP868_398	1.31187616386278
chr01	1000000	5750000	4750000	2x_LOP868_398	0.932550197637832_1.14011890509313_0.935203030560595_1.07445290036985_1.02940490189048_1.24249357529921_1.09396533804061_1.13797868284328_0.978571637468799_1.05841455111472_1.14464996853652_1.00269014702917_1.27135125709814_1.2067318071947_1.11447261511589_1.34743712925688_1.05092861782714_1.08194726266957_1.21122660027899
chr01	2500000	2750000	250000	2x_LOP868_480	1.71829519124282
chr01	2500000	2750000	250000	2x_LOP868_487	1.71829519124282
chr01	3250000	3500000	250000	2x_LOP868_077	2.0610140287176
chr01	4000000	4250000	250000	2x_LOP868_289	2.55852927567241
chr01	4000000	4250000	250000	2x_LOP868_479	1.55632774198039
chr01	5000000	5250000	250000	2x_LOP868_292	1.69394519981714
chr01	5000000	5250000	250000	2x_LOP868_493	1.69394519981714
chr01	6000000	9250000	3250000	2x_LOP868_398	1.34642050248062_1.13694378384062_1.08009720052282_1.36558443066101_1.38667807868331_1.20337613611737_1.21871690822052_1.16153612122409_1.25153297986659_1.06019639379337_1.18652614751577_1.36481201555493_1.3537420806015
chr01	6250000	6500000	250000	2x_LOP868_349	2.43419578602081
chr01	6250000	6500000	250000	2x_LOP868_479	2.43419578602081
chr01	6500000	6750000	250000	2x_LOP868_480	1.33681059792262
chr01	6500000	6750000	250000	2x_LOP868_493	1.71309725274417
chr01	7250000	7500000	250000	2x_LOP868_041	2.32308082454466
chr01	7250000	7500000	250000	2x_LOP868_1160	2.32308082454466
chr01	7250000	7500000	250000	2x_LOP868_262	2.32308082454466
chr01	7250000	7500000	250000	2x_LOP868_407	2.32308082454466
chr01	7500000	7750000	250000	2x_LOP868_474	2.47339515477179
chr01	7750000	8000000	250000	2x_LOP868_480	1.51629125874139
chr01	8750000	9000000	250000	2x_LOP868_479	1.36481201555493
chr01	8750000	9000000	250000	2x_LOP868_480	1.62815045510707
chr01	9000000	9250000	250000	2x_LOP868_474	1.3537420806015
chr01	9250000	9500000	250000	2x_LOP868_281	2.49225645901523
chr01	9250000	9500000	250000	2x_LOP868_286	2.49225645901523
chr01	10250000	10500000	250000	2x_LOP868_041	2.31841815532053
chr01	11250000	11500000	250000	2x_LOP868_513	2.39516289967175
chr01	12000000	12250000	250000	2x_LOP868_122	1.53782819770053
chr01	12750000	13000000	250000	2x_LOP868_398	1.17472810178206
chr01	13250000	13750000	500000	2x_LOP868_398	1.24569303281353_1.51578471984689
chr01	20250000	21000000	750000	2x_LOP868_398	2.57344322388178_2.8804383048765_2.81693857799013
chr01	21250000	21500000	250000	2x_LOP868_398	2.83180682602335
chr01	21750000	22250000	500000	2x_LOP868_398	2.99628267204411_3.0759780146877
chr01	23250000	24250000	1000000	2x_LOP868_398	2.72196383576805_2.88325123635192_2.76504510151122_2.76351231966234
chr01	23500000	23750000	250000	2x_LOP868_006	2.25970796921895
chr01	23750000	24000000	250000	2x_LOP868_480	2.23294033790194
chr01	24250000	26000000	1750000	2x_LOP868_488	3.41094883447572_3.06557090961548_2.99546463995936_3.18618814860801_3.40763912384866_3.49780360946406_3.4673627120934
chr01	27000000	27250000	250000	2x_LOP868_480	2.7704919102492
chr01	32000000	32250000	250000	2x_LOP868_006	2.13200064726792
chr01	32000000	32250000	250000	2x_LOP868_222	2.13200064726792
chr01	32000000	32250000	250000	2x_LOP868_248	2.13200064726792
chr01	32000000	32250000	250000	2x_LOP868_421	2.13200064726792
chr01	32000000	32250000	250000	2x_LOP868_474	1.70053315262067
chr01	32000000	32250000	250000	2x_LOP868_480	2.13200064726792
chr01	32000000	32250000	250000	2x_LOP868_485	2.13200064726792
chr01	32000000	32250000	250000	2x_LOP868_535	2.13200064726792
chr01	34750000	35000000	250000	2x_LOP868_076	2.21621013087277
chr01	34750000	35000000	250000	2x_LOP868_254	2.21621013087277
chr01	34750000	35000000	250000	2x_LOP868_479	2.21621013087277
chr01	36250000	36500000	250000	2x_LOP868_281	2.2940604001087
chr01	37000000	37250000	250000	2x_LOP868_254	2.13081330681225
chr01	37000000	37250000	250000	2x_LOP868_480	2.13081330681225
chr01	41750000	42000000	250000	2x_LOP868_398	1.11318015589511
chr01	42250000	42750000	500000	2x_LOP868_398	2.73809954884201_3.11645278312736
chr01	43000000	43750000	750000	2x_LOP868_398	1.30852903986553_1.26789684976727_1.15184642985822
chr01	43500000	43750000	250000	2x_LOP868_479	1.50088936915078
chr01	44750000	45000000	250000	2x_LOP868_513	2.21203414124524
chr01	48000000	48250000	250000	2x_LOP868_398	2.51375676245621
chr01	48500000	48750000	250000	2x_LOP868_286	2.63083131121071
chr01	52250000	52500000	250000	2x_LOP868_398	1.17103507442648
chr01	52750000	53500000	750000	2x_LOP868_398	3.62073013750142_3.77554554284778_3.41077846682848
chr01	54000000	56000000	2000000	2x_LOP868_398	2.92300780950337_2.9414432178869_2.99634535773041_3.12724058044274_3.26560570002313_2.8955011889005_2.86402729470835_2.75986356054591
chr01	54250000	54500000	250000	2x_LOP868_090	2.29342420688277
chr01	54250000	54500000	250000	2x_LOP868_116	2.29342420688277
chr01	54250000	54500000	250000	2x_LOP868_430	2.29342420688277
chr01	55500000	55750000	250000	2x_LOP868_485	2.25068723811515
chr01	56500000	56750000	250000	2x_LOP868_398	2.7121709975168
chr01	59250000	59500000	250000	2x_LOP868_387	2.31135924479393
chr01	59750000	60000000	250000	2x_LOP868_286	2.31041510309347
chr01	59750000	60000000	250000	2x_LOP868_450	2.31041510309347
chr01	60500000	60750000	250000	2x_LOP868_108	1.63697196680222
chr01	60500000	60750000	250000	2x_LOP868_479	1.63697196680222
chr01	60500000	60750000	250000	2x_LOP868_505	1.63697196680222
chr01	60500000	61000000	500000	2x_LOP868_480	1.63697196680222_1.62979080416307
chr01	60750000	61000000	250000	2x_LOP868_493	1.62979080416307
chr01	61500000	61750000	250000	2x_LOP868_311	2.01118178763481
chr01	62250000	62500000	250000	2x_LOP868_058	1.72660720792853
chr01	62250000	62500000	250000	2x_LOP868_361	1.72660720792853
chr01	62250000	62500000	250000	2x_LOP868_363	1.72660720792853
chr01	62250000	62500000	250000	2x_LOP868_365	1.72660720792853
chr01	62250000	62500000	250000	2x_LOP868_373	1.72660720792853
chr01	62250000	62500000	250000	2x_LOP868_480	1.72660720792853
chr01	62250000	62500000	250000	2x_LOP868_523	1.72660720792853
chr01	62500000	62750000	250000	2x_LOP868_493	1.61566489668823
chr01	66250000	66500000	250000	2x_LOP868_299	2.3346529954997
chr01	66250000	66500000	250000	2x_LOP868_461	2.3346529954997
chr01	66500000	66750000	250000	2x_LOP868_493	1.71635898250851
chr01	67000000	67250000	250000	2x_LOP868_480	1.54978914314509
chr01	67000000	68250000	1250000	2x_LOP868_292	2.86210626204556_2.75198624810302_2.75201283665263_2.95101946189135_2.9516657808141
chr01	67000000	68250000	1250000	2x_LOP868_460	2.92916671264616_2.75198624810302_2.87257430834809_2.95101946189135_2.9516657808141
chr01	67250000	67500000	250000	2x_LOP868_289	1.62392582854294
chr01	68250000	68500000	250000	2x_LOP868_090	2.41541893063187
chr01	69500000	69750000	250000	2x_LOP868_081	2.30663432532059
chr01	69500000	69750000	250000	2x_LOP868_254	2.30663432532059
chr01	70500000	70750000	250000	2x_LOP868_289	1.56512304757104
chr01	70750000	71000000	250000	2x_LOP868_072	2.57737505212985
chr01	71250000	71500000	250000	2x_LOP868_072	2.57342333528826
chr01	71750000	72000000	250000	2x_LOP868_072	2.37459943561476
chr01	72250000	72500000	250000	2x_LOP868_065	1.64785338309253
chr01	74000000	74250000	250000	2x_LOP868_090	2.38740768754402
chr01	75750000	76000000	250000	2x_LOP868_072	2.36009457185372
chr01	77000000	77250000	250000	2x_LOP868_480	2.32656674379822
chr01	77750000	78000000	250000	2x_LOP868_479	1.6079595993721
chr01	78750000	79000000	250000	2x_LOP868_474	1.72353344792879
chr01	78750000	79000000	250000	2x_LOP868_480	1.63580851289483
chr01	79750000	80000000	250000	2x_LOP868_387	2.25030137869793
chr01	79750000	80000000	250000	2x_LOP868_479	2.25030137869793
chr01	80000000	80250000	250000	2x_LOP868_048	2.16819912870645
chr01	80000000	80250000	250000	2x_LOP868_090	2.16819912870645
chr01	80000000	80250000	250000	2x_LOP868_289	1.66546089517506
chr01	80000000	80250000	250000	2x_LOP868_306	2.16819912870645
chr01	80000000	80250000	250000	2x_LOP868_308	2.16819912870645
chr01	80000000	80250000	250000	2x_LOP868_473	2.16819912870645
chr01	80000000	80250000	250000	2x_LOP868_480	2.27609976754173
chr01	80500000	80750000	250000	2x_LOP868_469	2.23217784142946
chr01	82750000	83000000	250000	2x_LOP868_267	2.26810303902802
chr01	82750000	83000000	250000	2x_LOP868_465	2.26810303902802
chr01	82750000	83000000	250000	2x_LOP868_480	1.70507820372332
chr01	83750000	84000000	250000	2x_LOP868_480	1.61075841891923
chr01	84000000	84250000	250000	2x_LOP868_076	2.38128533390877
chr01	85250000	85500000	250000	2x_LOP868_037	1.99452057898049
chr01	85250000	85500000	250000	2x_LOP868_045	1.99452057898049
chr01	85250000	85500000	250000	2x_LOP868_1160	1.99452057898049
chr01	85250000	85500000	250000	2x_LOP868_219	1.99452057898049
chr01	85250000	85500000	250000	2x_LOP868_222	1.99452057898049
chr01	85250000	85500000	250000	2x_LOP868_244	1.99452057898049
chr01	85250000	85500000	250000	2x_LOP868_254	1.99452057898049
chr01	85250000	85500000	250000	2x_LOP868_403	1.99452057898049
chr01	88000000	88250000	250000	2x_LOP868_477	2.40346896889659
chr01	88500000	88663952	163952	2x_LOP868_299	3.10490507160659
chr02	500000	750000	250000	2x_LOP868_474	3.19842136658181
chr02	13250000	13500000	250000	2x_LOP868_479	2.23582476402289
chr02	16750000	17000000	250000	2x_LOP868_267	2.65102005544331
chr02	18250000	18500000	250000	2x_LOP868_474	1.69630750800792
chr02	22250000	22500000	250000	2x_LOP868_480	1.61505869705364
chr02	22500000	22750000	250000	2x_LOP868_467	2.28916409258745
chr02	25750000	26000000	250000	2x_LOP868_072	2.66023794459821
chr02	27000000	27250000	250000	2x_LOP868_479	1.61933789570626
chr02	27000000	27250000	250000	2x_LOP868_480	1.61933789570626
chr02	31000000	31250000	250000	2x_LOP868_420	1.67598316431813
chr02	31000000	31250000	250000	2x_LOP868_480	1.67598316431813
chr02	31500000	31750000	250000	2x_LOP868_480	2.44823379333456
chr02	32500000	32750000	250000	2x_LOP868_494	1.36892992686816
chr02	33000000	33250000	250000	2x_LOP868_479	1.61278901250317
chr02	33000000	33250000	250000	2x_LOP868_493	1.61278901250317
chr02	33500000	33750000	250000	2x_LOP868_480	1.586014791462
chr02	35000000	35250000	250000	2x_LOP868_479	1.63601592366584
chr02	36000000	36250000	250000	2x_LOP868_439	2.26608121161261
chr02	36000000	36250000	250000	2x_LOP868_480	1.58394195898044
chr02	36250000	36500000	250000	2x_LOP868_461	1.68959901651448
chr02	40750000	41000000	250000	2x_LOP868_289	1.62700592866359
chr02	41750000	42000000	250000	2x_LOP868_286	1.65951692842536
chr02	41750000	42000000	250000	2x_LOP868_289	1.65951692842536
chr02	42250000	42750000	500000	2x_LOP868_479	1.62589990779051_1.76087753272476
chr02	42500000	42750000	250000	2x_LOP868_128	1.76087753272476
chr02	42500000	43000000	500000	2x_LOP868_480	1.76087753272476_1.66822341527976
chr02	46750000	47000000	250000	2x_LOP868_281	1.75981360588302
chr02	46750000	47000000	250000	2x_LOP868_286	1.75981360588302
chr02	46750000	47000000	250000	2x_LOP868_289	1.75981360588302
chr02	46750000	47000000	250000	2x_LOP868_480	1.75981360588302
chr02	47750000	48000000	250000	2x_LOP868_439	2.26735305928103
chr02	48250000	48500000	250000	2x_LOP868_289	1.65758741013564
chr03	1500000	1750000	250000	2x_LOP868_479	1.60462896523032
chr03	1750000	2000000	250000	2x_LOP868_493	1.71001547566074
chr03	2000000	2250000	250000	2x_LOP868_480	1.6315318893317
chr03	6250000	6500000	250000	2x_LOP868_480	1.65925114373289
chr03	12500000	12750000	250000	2x_LOP868_479	6.32972305024911
chr03	13750000	14000000	250000	2x_LOP868_396	2.19612888614691
chr03	13750000	14000000	250000	2x_LOP868_428	2.19612888614691
chr03	13750000	14000000	250000	2x_LOP868_485	2.19612888614691
chr03	15750000	16000000	250000	2x_LOP868_072	2.41137839924431
chr03	16500000	16750000	250000	2x_LOP868_117	1.47735257692302
chr03	17250000	17500000	250000	2x_LOP868_372	2.36870057586369
chr03	17750000	18000000	250000	2x_LOP868_065	1.56260761801187
chr03	18250000	18500000	250000	2x_LOP868_090	1.57563067982848
chr03	18250000	18500000	250000	2x_LOP868_172	1.57563067982848
chr03	18250000	18500000	250000	2x_LOP868_433	1.57563067982848
chr03	18250000	18500000	250000	2x_LOP868_479	2.17689801894424
chr03	22500000	22750000	250000	2x_LOP868_429	2.19465716363972
chr03	22500000	22750000	250000	2x_LOP868_463	2.19465716363972
chr03	22750000	23000000	250000	2x_LOP868_479	2.27357736957108
chr03	23750000	24000000	250000	2x_LOP868_281	2.2949336456997
chr03	23750000	24000000	250000	2x_LOP868_286	2.2949336456997
chr03	31500000	31750000	250000	2x_LOP868_510	2.28244321739394
chr03	34000000	34250000	250000	2x_LOP868_474	3.58068304682158
chr03	35250000	35500000	250000	2x_LOP868_480	1.61689916304212
chr03	37250000	37500000	250000	2x_LOP868_128	1.68105639195094
chr03	37250000	37500000	250000	2x_LOP868_401	1.68105639195094
chr03	37250000	37500000	250000	2x_LOP868_420	1.68105639195094
chr03	37250000	37500000	250000	2x_LOP868_474	2.32439663515995
chr03	40750000	41000000	250000	2x_LOP868_479	1.52152512574664
chr03	42500000	42750000	250000	2x_LOP868_480	1.54053742117588
chr03	45250000	45500000	250000	2x_LOP868_480	1.61558726647684
chr03	47500000	47750000	250000	2x_LOP868_480	1.44520415517316
chr03	53750000	54000000	250000	2x_LOP868_480	1.54809039041907
chr03	54750000	55000000	250000	2x_LOP868_487	1.72765193276117
chr03	55250000	55500000	250000	2x_LOP868_234	2.22557485464011
chr03	55250000	55500000	250000	2x_LOP868_465	2.22557485464011
chr03	55250000	55500000	250000	2x_LOP868_480	2.22557485464011
chr03	58250000	58500000	250000	2x_LOP868_465	2.40269805224745
chr03	58500000	58750000	250000	2x_LOP868_289	1.6292388506832
chr03	59000000	59250000	250000	2x_LOP868_289	1.70647771013644
chr03	59000000	59250000	250000	2x_LOP868_396	2.34827486200172
chr03	59000000	59250000	250000	2x_LOP868_479	1.70647771013644
chr03	59750000	60000000	250000	2x_LOP868_247	2.32187807899865
chr03	60500000	60750000	250000	2x_LOP868_428	2.30735920562114
chr04	500000	750000	250000	2x_LOP868_474	3.58542192025314
chr04	4500000	4750000	250000	2x_LOP868_1196	0.915639762042612
chr04	4500000	4750000	250000	2x_LOP868_251	0.915639762042612
chr04	4500000	4750000	250000	2x_LOP868_417	0.915639762042612
chr04	4500000	4750000	250000	2x_LOP868_525	0.915639762042612
chr04	8750000	9000000	250000	2x_LOP868_037	1.13594365320061
chr04	8750000	9000000	250000	2x_LOP868_048	1.13594365320061
chr04	8750000	9000000	250000	2x_LOP868_1196	1.13594365320061
chr04	8750000	9000000	250000	2x_LOP868_131	1.13594365320061
chr04	8750000	9000000	250000	2x_LOP868_222	1.13594365320061
chr04	8750000	9000000	250000	2x_LOP868_270	1.13594365320061
chr04	8750000	9000000	250000	2x_LOP868_286	1.13594365320061
chr04	9250000	9500000	250000	2x_LOP868_037	0.842717721447088
chr04	9250000	9500000	250000	2x_LOP868_048	0.842717721447088
chr04	9250000	9500000	250000	2x_LOP868_1196	0.842717721447088
chr04	9250000	9500000	250000	2x_LOP868_131	0.842717721447088
chr04	9250000	9500000	250000	2x_LOP868_222	0.842717721447088
chr04	9250000	9500000	250000	2x_LOP868_270	0.842717721447088
chr04	9250000	9500000	250000	2x_LOP868_286	0.842717721447088
chr04	11000000	11250000	250000	2x_LOP868_493	2.39527190756557
chr04	11750000	12000000	250000	2x_LOP868_205	1.42507900763374
chr04	12000000	12250000	250000	2x_LOP868_373	1.66476704733302
chr04	13000000	14000000	1000000	2x_LOP868_272	3.2348146998429_3.35234930906571_2.96005818205725_2.84759808667704
chr04	13750000	14000000	250000	2x_LOP868_065	2.84759808667704
chr04	13750000	14000000	250000	2x_LOP868_258	1.8327507029953
chr04	21250000	21500000	250000	2x_LOP868_474	1.61808131720971
chr04	22500000	22750000	250000	2x_LOP868_172	1.56979382403401
chr04	23000000	23250000	250000	2x_LOP868_363	1.68865389234587
chr04	23000000	23250000	250000	2x_LOP868_456	1.68865389234587
chr04	23500000	23750000	250000	2x_LOP868_479	2.64804215519489
chr04	26500000	26750000	250000	2x_LOP868_485	2.28222038607161
chr04	27250000	27500000	250000	2x_LOP868_272	1.52990536394923
chr04	27250000	27500000	250000	2x_LOP868_487	1.52990536394923
chr04	37250000	37500000	250000	2x_LOP868_311	2.27195085000101
chr04	37250000	37500000	250000	2x_LOP868_479	2.27195085000101
chr04	37250000	37750000	500000	2x_LOP868_485	2.27195085000101_2.50638895971177
chr04	38750000	39000000	250000	2x_LOP868_172	1.43163124902834
chr04	41500000	42000000	500000	2x_LOP868_485	2.64203967655386_3.57455064584566
chr04	43250000	43500000	250000	2x_LOP868_485	2.45852609711732
chr04	43750000	44000000	250000	2x_LOP868_172	1.65432661527366
chr04	45000000	45250000	250000	2x_LOP868_485	2.53964783609858
chr04	45250000	45500000	250000	2x_LOP868_456	2.36401607736947
chr04	46000000	46250000	250000	2x_LOP868_281	2.70270094073554
chr04	46000000	46250000	250000	2x_LOP868_286	2.70270094073554
chr04	46500000	46750000	250000	2x_LOP868_487	1.51635265798603
chr04	47750000	48000000	250000	2x_LOP868_479	2.51957731469882
chr04	48500000	48750000	250000	2x_LOP868_454	1.6396471925108
chr04	52250000	52500000	250000	2x_LOP868_308	2.47833696635961
chr04	52250000	52500000	250000	2x_LOP868_480	1.64087098993065
chr04	54000000	54250000	250000	2x_LOP868_123	2.49860890903715
chr04	54000000	54250000	250000	2x_LOP868_459	2.49860890903715
chr04	55250000	55500000	250000	2x_LOP868_479	1.64804717244316
chr04	55250000	55500000	250000	2x_LOP868_480	1.64804717244316
chr04	55250000	55500000	250000	2x_LOP868_493	1.64804717244316
chr04	56750000	57000000	250000	2x_LOP868_488	3.0737207754997
chr04	61500000	61750000	250000	2x_LOP868_274	2.28345872715694
chr04	65250000	65500000	250000	2x_LOP868_308	2.38435653186779
chr04	65500000	65750000	250000	2x_LOP868_493	1.56900004910124
chr04	66500000	66750000	250000	2x_LOP868_479	1.50776312068894
chr04	67250000	67500000	250000	2x_LOP868_406	1.65160057609267
chr04	69000000	69250000	250000	2x_LOP868_414	1.7164404327636
chr04	69000000	69250000	250000	2x_LOP868_480	1.7164404327636
chr04	71750000	72000000	250000	2x_LOP868_060	1.72925225017738
chr04	71750000	72000000	250000	2x_LOP868_272	1.72925225017738
chr04	72000000	72208621	208621	2x_LOP868_463	2.53899252016123
chr04	72000000	72208621	208621	2x_LOP868_480	2.53899252016123
chr05	1000000	1250000	250000	2x_LOP868_439	2.3400986355154
chr05	1500000	1750000	250000	2x_LOP868_487	1.57092831424447
chr05	2750000	3000000	250000	2x_LOP868_493	1.62886221765594
chr05	3500000	3750000	250000	2x_LOP868_090	2.36785975967952
chr05	5500000	5750000	250000	2x_LOP868_487	1.76278208143201
chr05	6250000	6500000	250000	2x_LOP868_289	1.65172203387897
chr05	6500000	6750000	250000	2x_LOP868_016	2.27090097310994
chr05	7000000	7250000	250000	2x_LOP868_090	2.44971848339508
chr05	8250000	8500000	250000	2x_LOP868_090	2.71852699666975
chr05	8750000	9000000	250000	2x_LOP868_480	1.57266529987782
chr05	16000000	16250000	250000	2x_LOP868_480	2.41192288336637
chr05	17500000	17750000	250000	2x_LOP868_480	2.45790766031674
chr05	21250000	21500000	250000	2x_LOP868_090	3.0173884896248
chr05	29000000	29250000	250000	2x_LOP868_480	2.38888725284415
chr05	30500000	30750000	250000	2x_LOP868_090	2.50780136597904
chr05	32500000	32750000	250000	2x_LOP868_281	2.35284656497251
chr05	41750000	42000000	250000	2x_LOP868_387	2.62619394488272
chr05	41750000	42000000	250000	2x_LOP868_429	2.62619394488272
chr05	41750000	42000000	250000	2x_LOP868_467	2.62619394488272
chr05	42500000	42750000	250000	2x_LOP868_108	1.93894960603503
chr05	43750000	44000000	250000	2x_LOP868_090	2.28775537130771
chr05	43750000	44000000	250000	2x_LOP868_479	1.6133874920367
chr05	44000000	44250000	250000	2x_LOP868_236	1.56870606198624
chr05	44000000	44250000	250000	2x_LOP868_523	1.56870606198624
chr05	48500000	48750000	250000	2x_LOP868_487	1.64794485557891
chr05	48500000	49000000	500000	2x_LOP868_479	1.64794485557891_1.65993028903451
chr05	48750000	49000000	250000	2x_LOP868_128	1.65993028903451
chr05	51000000	51250000	250000	2x_LOP868_090	2.37039895401878
chr05	51250000	51500000	250000	2x_LOP868_286	1.66438896597263
chr05	51250000	51500000	250000	2x_LOP868_480	1.66438896597263
chr06	250000	500000	250000	2x_LOP868_474	1.6059352111752
chr06	750000	1000000	250000	2x_LOP868_480	1.57224345735257
chr06	2000000	2250000	250000	2x_LOP868_480	1.63685906685963
chr06	2750000	3000000	250000	2x_LOP868_480	1.41886528075713
chr06	3500000	3750000	250000	2x_LOP868_046	1.37445513367098
chr06	4250000	4500000	250000	2x_LOP868_456	1.6296533799548
chr06	7750000	8000000	250000	2x_LOP868_365	3.13639278952239
chr06	12750000	13000000	250000	2x_LOP868_480	2.52407748145023
chr06	14250000	14500000	250000	2x_LOP868_479	2.2476817479462
chr06	14750000	15000000	250000	2x_LOP868_042	2.5178161044378
chr06	14750000	15000000	250000	2x_LOP868_043	2.5178161044378
chr06	14750000	15000000	250000	2x_LOP868_479	2.29050406554955
chr06	14750000	15000000	250000	2x_LOP868_493	2.29050406554955
chr06	18250000	18500000	250000	2x_LOP868_258	1.57070867246788
chr06	19000000	19250000	250000	2x_LOP868_485	2.21404260168506
chr06	21250000	21500000	250000	2x_LOP868_479	2.2402892175768
chr06	22000000	22250000	250000	2x_LOP868_479	2.3005375373579
chr06	23250000	23500000	250000	2x_LOP868_479	2.16649513950589
chr06	23250000	23500000	250000	2x_LOP868_480	2.16649513950589
chr06	24750000	25000000	250000	2x_LOP868_479	2.14848160627418
chr06	25750000	26000000	250000	2x_LOP868_479	2.35713137316957
chr06	26500000	26750000	250000	2x_LOP868_025	1.61862972883521
chr06	26500000	26750000	250000	2x_LOP868_043	1.61862972883521
chr06	26500000	26750000	250000	2x_LOP868_219	1.61862972883521
chr06	26500000	26750000	250000	2x_LOP868_257	1.61862972883521
chr06	26500000	26750000	250000	2x_LOP868_268	1.61862972883521
chr06	26500000	26750000	250000	2x_LOP868_273	1.61862972883521
chr06	26500000	26750000	250000	2x_LOP868_363	1.61862972883521
chr06	26500000	26750000	250000	2x_LOP868_474	1.61862972883521
chr06	32000000	32250000	250000	2x_LOP868_292	1.90033769570913
chr06	32000000	32250000	250000	2x_LOP868_406	1.90033769570913
chr06	32000000	32250000	250000	2x_LOP868_430	1.90033769570913
chr06	32000000	32250000	250000	2x_LOP868_459	1.90033769570913
chr06	32000000	32250000	250000	2x_LOP868_474	1.90033769570913
chr06	32000000	32250000	250000	2x_LOP868_538	1.90033769570913
chr06	34750000	35000000	250000	2x_LOP868_062	1.62702304242749
chr06	35500000	35750000	250000	2x_LOP868_454	1.68919528269874
chr06	35500000	35750000	250000	2x_LOP868_479	1.68919528269874
chr06	35500000	35750000	250000	2x_LOP868_494	1.68919528269874
chr06	38750000	39000000	250000	2x_LOP868_480	1.50573482788146
chr06	41000000	41250000	250000	2x_LOP868_028	1.81665551069772
chr06	41000000	41250000	250000	2x_LOP868_480	1.81665551069772
chr06	41000000	41250000	250000	2x_LOP868_487	1.81665551069772
chr06	42000000	42250000	250000	2x_LOP868_403	3.83709486861853
chr06	42500000	42750000	250000	2x_LOP868_403	3.05333806484732
chr06	43500000	43750000	250000	2x_LOP868_479	1.51991608198903
chr06	43500000	43750000	250000	2x_LOP868_480	1.51991608198903
chr06	45000000	45250000	250000	2x_LOP868_403	2.48082250785942
chr06	45000000	45250000	250000	2x_LOP868_479	1.40141677947536
chr06	45750000	46000000	250000	2x_LOP868_060	1.71124785279722
chr06	45750000	46000000	250000	2x_LOP868_281	1.71124785279722
chr06	45750000	46000000	250000	2x_LOP868_286	1.71124785279722
chr06	45750000	46000000	250000	2x_LOP868_289	1.71124785279722
chr06	47000000	47250000	250000	2x_LOP868_480	1.65710369579081
chr06	47250000	47500000	250000	2x_LOP868_479	1.22363848441603
chr06	49750000	50000000	250000	2x_LOP868_281	1.7523504624191
chr06	51000000	51250000	250000	2x_LOP868_309	2.35160581213335
chr06	51250000	51500000	250000	2x_LOP868_513	1.53351639012716
chr06	51500000	51750000	250000	2x_LOP868_480	1.65423001538771
chr06	52750000	53000000	250000	2x_LOP868_074	1.95328449584337
chr06	53250000	53500000	250000	2x_LOP868_043	2.46918861801492
chr06	53250000	53750000	500000	2x_LOP868_372	2.46918861801492_2.44472764091761
chr06	53500000	53750000	250000	2x_LOP868_311	2.44472764091761
chr06	54750000	55000000	250000	2x_LOP868_479	1.60300587672295
chr06	56250000	56500000	250000	2x_LOP868_479	1.64251589983136
chr06	57500000	57750000	250000	2x_LOP868_480	1.72067259398175
chr06	58000000	58250000	250000	2x_LOP868_480	1.5018633894477
chr06	58500000	58750000	250000	2x_LOP868_286	1.72465530720876
chr06	58500000	58750000	250000	2x_LOP868_289	1.72465530720876
chr07	0	250000	250000	2x_LOP868_479	2.69246099197784
chr07	2250000	2500000	250000	2x_LOP868_479	1.68840926308768
chr07	3000000	3250000	250000	2x_LOP868_480	1.47210995632999
chr07	5750000	6000000	250000	2x_LOP868_474	2.49463993396915
chr07	5750000	6000000	250000	2x_LOP868_479	1.63858180405564
chr07	6000000	6250000	250000	2x_LOP868_363	1.60486515886249
chr07	6000000	6250000	250000	2x_LOP868_480	1.60486515886249
chr07	6250000	6500000	250000	2x_LOP868_072	2.37508612289677
chr07	7000000	7500000	500000	2x_LOP868_480	1.51302934693676_1.60695266649571
chr07	7250000	7500000	250000	2x_LOP868_479	1.60695266649571
chr07	7250000	7500000	250000	2x_LOP868_493	1.60695266649571
chr07	13250000	13500000	250000	2x_LOP868_171	1.86889621641412
chr07	13250000	13500000	250000	2x_LOP868_289	1.86889621641412
chr07	13250000	13500000	250000	2x_LOP868_373	1.86889621641412
chr07	13250000	13500000	250000	2x_LOP868_387	1.86889621641412
chr07	13250000	13500000	250000	2x_LOP868_425	1.86889621641412
chr07	13250000	13500000	250000	2x_LOP868_452	1.86889621641412
chr07	13250000	13500000	250000	2x_LOP868_454	1.86889621641412
chr07	13250000	13500000	250000	2x_LOP868_473	1.86889621641412
chr07	13250000	13500000	250000	2x_LOP868_522	2.40284133522434
chr07	29500000	29750000	250000	2x_LOP868_474	3.41878149164937
chr07	31250000	31500000	250000	2x_LOP868_480	2.24540676286508
chr07	42000000	42250000	250000	2x_LOP868_076	2.41614597394112
chr07	42750000	43000000	250000	2x_LOP868_479	1.39879506096574
chr07	43000000	43250000	250000	2x_LOP868_289	1.6564665269808
chr07	43250000	43500000	250000	2x_LOP868_480	1.55385738807067
chr07	44000000	44250000	250000	2x_LOP868_480	1.55289083984847
chr07	45000000	45250000	250000	2x_LOP868_293	2.52322085850141
chr07	45750000	46000000	250000	2x_LOP868_306	2.47493564553551
chr07	45750000	46000000	250000	2x_LOP868_488	1.61144093827414
chr07	47500000	47750000	250000	2x_LOP868_064	2.36322988652531
chr07	50750000	51000000	250000	2x_LOP868_485	2.00018609871702
chr07	51000000	51250000	250000	2x_LOP868_308	2.27041253611808
chr07	51000000	51250000	250000	2x_LOP868_479	1.61923592516875
chr07	51250000	51500000	250000	2x_LOP868_487	1.7152707119932
chr07	52750000	53000000	250000	2x_LOP868_363	1.7752719517071
chr07	52750000	53000000	250000	2x_LOP868_454	1.7752719517071
chr07	53250000	53500000	250000	2x_LOP868_479	1.42056388638135
chr07	53250000	53500000	250000	2x_LOP868_480	1.68954867501584
chr07	53250000	53500000	250000	2x_LOP868_493	1.68954867501584
chr07	53750000	54000000	250000	2x_LOP868_493	1.65463909316641
chr07	54000000	54250000	250000	2x_LOP868_028	1.61080104556457
chr07	54750000	55000000	250000	2x_LOP868_015	2.29000452660702
chr07	54750000	55000000	250000	2x_LOP868_281	1.6211241904763
chr07	55000000	55250000	250000	2x_LOP868_479	1.58652969937173
chr08	3000000	3250000	250000	2x_LOP868_450	2.72379401531093
chr08	3500000	3750000	250000	2x_LOP868_090	2.36129498305859
chr08	4000000	4500000	500000	2x_LOP868_480	1.63442130352668_1.69092213856206
chr08	6250000	6500000	250000	2x_LOP868_258	1.76721850159823
chr08	6250000	6500000	250000	2x_LOP868_461	1.76721850159823
chr08	6250000	6500000	250000	2x_LOP868_493	1.76721850159823
chr08	6500000	6750000	250000	2x_LOP868_479	1.5004649717306
chr08	6500000	6750000	250000	2x_LOP868_487	1.5004649717306
chr08	7500000	7750000	250000	2x_LOP868_479	1.67616133034497
chr08	7500000	7750000	250000	2x_LOP868_480	1.67616133034497
chr08	9500000	9750000	250000	2x_LOP868_076	2.5455912393338
chr08	9500000	9750000	250000	2x_LOP868_417	2.5455912393338
chr08	10500000	10750000	250000	2x_LOP868_172	1.62480042253393
chr08	10750000	11000000	250000	2x_LOP868_502	2.23344726033158
chr08	11500000	11750000	250000	2x_LOP868_479	2.42956270922367
chr08	13000000	13250000	250000	2x_LOP868_474	1.49115641159649
chr08	13000000	13250000	250000	2x_LOP868_480	1.49115641159649
chr08	15000000	15250000	250000	2x_LOP868_281	5.96545420029689
chr08	15750000	16000000	250000	2x_LOP868_172	1.65095267788525
chr08	15750000	16000000	250000	2x_LOP868_433	1.65095267788525
chr08	16250000	16500000	250000	2x_LOP868_281	2.20575256588601
chr08	16250000	16500000	250000	2x_LOP868_286	2.20575256588601
chr08	18000000	18250000	250000	2x_LOP868_373	1.58063402048449
chr08	32250000	32500000	250000	2x_LOP868_072	2.21099322553233
chr08	34250000	34500000	250000	2x_LOP868_487	1.59237477698436
chr08	34750000	35000000	250000	2x_LOP868_479	2.39679451723134
chr08	37250000	37500000	250000	2x_LOP868_043	2.47998621247246
chr08	38000000	38250000	250000	2x_LOP868_281	2.2826784381831
chr08	40000000	40250000	250000	2x_LOP868_439	2.46363550095618
chr08	40250000	40500000	250000	2x_LOP868_062	0.756511531442261
chr08	40250000	40500000	250000	2x_LOP868_076	0.756511531442261
chr08	40250000	40500000	250000	2x_LOP868_304	0.756511531442261
chr08	40250000	40500000	250000	2x_LOP868_305	0.756511531442261
chr08	40250000	40500000	250000	2x_LOP868_417	0.756511531442261
chr08	41250000	41500000	250000	2x_LOP868_062	1.54707327451935
chr08	41250000	41500000	250000	2x_LOP868_479	1.54707327451935
chr08	41250000	41500000	250000	2x_LOP868_480	1.54707327451935
chr08	41250000	41500000	250000	2x_LOP868_487	1.54707327451935
chr08	41750000	42000000	250000	2x_LOP868_305	0.408144500882237
chr08	43000000	43250000	250000	2x_LOP868_439	2.37957870040236
chr08	43500000	43750000	250000	2x_LOP868_090	2.49899417799695
chr08	43500000	43750000	250000	2x_LOP868_497	2.49899417799695
chr08	44500000	44750000	250000	2x_LOP868_305	1.10999256748005
chr08	44500000	44750000	250000	2x_LOP868_480	1.10999256748005
chr08	46250000	46500000	250000	2x_LOP868_305	1.4681521506694
chr08	46500000	46750000	250000	2x_LOP868_030	2.85919320805439
chr08	49000000	49750000	750000	2x_LOP868_480	1.52419402790457_1.65093228488875_1.48469373058135
chr08	50750000	51000000	250000	2x_LOP868_479	1.51968663485305
chr08	52500000	52750000	250000	2x_LOP868_474	2.44284108954805
chr08	52750000	53000000	250000	2x_LOP868_479	1.63596595330689
chr08	53750000	54000000	250000	2x_LOP868_308	2.007226732491
chr08	53750000	54000000	250000	2x_LOP868_417	2.007226732491
chr08	53750000	54000000	250000	2x_LOP868_439	2.007226732491
chr08	54500000	54750000	250000	2x_LOP868_062	1.72130924385273
chr08	54500000	54750000	250000	2x_LOP868_480	1.72130924385273
chr08	55000000	55250000	250000	2x_LOP868_480	1.56568337212729
chr08	56000000	56250000	250000	2x_LOP868_172	1.65308056548733
chr08	56000000	56250000	250000	2x_LOP868_286	1.65308056548733
chr09	250000	500000	250000	2x_LOP868_224	1.76821625933952
chr09	250000	500000	250000	2x_LOP868_281	1.76821625933952
chr09	250000	500000	250000	2x_LOP868_479	1.76821625933952
chr09	250000	500000	250000	2x_LOP868_487	1.76821625933952
chr09	1750000	2000000	250000	2x_LOP868_480	1.66767737240172
chr09	2250000	2500000	250000	2x_LOP868_474	1.67365408764976
chr09	2500000	2750000	250000	2x_LOP868_349	2.28015160893728
chr09	2500000	2750000	250000	2x_LOP868_450	2.28015160893728
chr09	2750000	3000000	250000	2x_LOP868_469	2.52377991408385
chr09	2750000	3000000	250000	2x_LOP868_479	1.62887918468069
chr09	3000000	3250000	250000	2x_LOP868_480	1.63842551494235
chr09	3000000	3250000	250000	2x_LOP868_493	1.63842551494235
chr09	3500000	3750000	250000	2x_LOP868_480	1.57019486547468
chr09	3750000	4000000	250000	2x_LOP868_254	2.39959393004154
chr09	3750000	4000000	250000	2x_LOP868_493	1.71189975488392
chr09	4750000	5000000	250000	2x_LOP868_487	1.724576265634
chr09	5000000	5250000	250000	2x_LOP868_480	1.64050309852659
chr09	5250000	5500000	250000	2x_LOP868_308	2.24681908904447
chr09	5500000	5750000	250000	2x_LOP868_480	1.66478231150586
chr09	5500000	5750000	250000	2x_LOP868_493	1.66478231150586
chr09	5750000	6000000	250000	2x_LOP868_043	1.4976087553303
chr09	5750000	6000000	250000	2x_LOP868_128	1.4976087553303
chr09	5750000	6000000	250000	2x_LOP868_278	1.4976087553303
chr09	5750000	6000000	250000	2x_LOP868_425	1.4976087553303
chr09	6000000	6250000	250000	2x_LOP868_487	1.62818453043953
chr09	6750000	7000000	250000	2x_LOP868_286	3.24083949575066
chr09	9500000	9750000	250000	2x_LOP868_480	1.40260166017006
chr09	11500000	11750000	250000	2x_LOP868_254	2.3689733672963
chr09	13500000	13750000	250000	2x_LOP868_435	2.12087474487388
chr09	13500000	14000000	500000	2x_LOP868_493	2.12087474487388_2.27739409542781
chr09	13750000	14000000	250000	2x_LOP868_304	1.54864702774425
chr09	13750000	14000000	250000	2x_LOP868_430	1.54864702774425
chr09	14250000	14500000	250000	2x_LOP868_493	2.26454605077193
chr09	15000000	15500000	500000	2x_LOP868_493	2.18434321641418_2.59002729088135
chr09	15000000	15500000	500000	2x_LOP868_499	2.18434321641418_2.59002729088135
chr09	15250000	15500000	250000	2x_LOP868_045	2.59002729088135
chr09	15750000	16000000	250000	2x_LOP868_289	1.5073951908082
chr09	16250000	16500000	250000	2x_LOP868_523	2.09358008932531
chr09	16750000	17000000	250000	2x_LOP868_045	2.20425363260885
chr09	16750000	17000000	250000	2x_LOP868_278	2.20425363260885
chr09	16750000	17000000	250000	2x_LOP868_309	2.20425363260885
chr09	16750000	17000000	250000	2x_LOP868_435	2.20425363260885
chr09	16750000	17000000	250000	2x_LOP868_493	2.20425363260885
chr09	16750000	17000000	250000	2x_LOP868_494	2.20425363260885
chr09	16750000	17000000	250000	2x_LOP868_499	2.20425363260885
chr09	17250000	17500000	250000	2x_LOP868_480	2.28876956577779
chr09	17250000	17500000	250000	2x_LOP868_493	2.28876956577779
chr09	19000000	19250000	250000	2x_LOP868_493	2.38071140597962
chr09	19250000	19500000	250000	2x_LOP868_480	2.24706756802262
chr09	19750000	20000000	250000	2x_LOP868_062	2.02847099825223
chr09	19750000	20000000	250000	2x_LOP868_435	2.02847099825223
chr09	19750000	20000000	250000	2x_LOP868_480	2.02847099825223
chr09	19750000	20000000	250000	2x_LOP868_493	2.02847099825223
chr09	19750000	20000000	250000	2x_LOP868_499	2.02847099825223
chr09	22500000	22750000	250000	2x_LOP868_045	2.4592308933761
chr09	22500000	22750000	250000	2x_LOP868_062	2.4592308933761
chr09	22500000	22750000	250000	2x_LOP868_224	2.4592308933761
chr09	22500000	22750000	250000	2x_LOP868_272	2.4592308933761
chr09	22500000	22750000	250000	2x_LOP868_278	2.4592308933761
chr09	22500000	22750000	250000	2x_LOP868_435	2.70710457397573
chr09	22500000	22750000	250000	2x_LOP868_493	2.70710457397573
chr09	22500000	22750000	250000	2x_LOP868_494	2.4592308933761
chr09	22500000	22750000	250000	2x_LOP868_499	2.70710457397573
chr09	23000000	23250000	250000	2x_LOP868_045	2.22882067913568
chr09	23000000	23250000	250000	2x_LOP868_062	2.22882067913568
chr09	23000000	23250000	250000	2x_LOP868_224	2.22882067913568
chr09	23000000	23250000	250000	2x_LOP868_272	2.22882067913568
chr09	23000000	23250000	250000	2x_LOP868_278	2.22882067913568
chr09	23000000	23250000	250000	2x_LOP868_435	2.22882067913568
chr09	23000000	23250000	250000	2x_LOP868_493	2.51858410874434
chr09	23000000	23250000	250000	2x_LOP868_494	2.22882067913568
chr09	23000000	23250000	250000	2x_LOP868_499	2.22882067913568
chr09	24000000	24250000	250000	2x_LOP868_045	2.38691396882464
chr09	24000000	24250000	250000	2x_LOP868_062	2.38691396882464
chr09	24000000	24250000	250000	2x_LOP868_224	2.38691396882464
chr09	24000000	24250000	250000	2x_LOP868_278	2.38691396882464
chr09	24000000	24250000	250000	2x_LOP868_494	2.38691396882464
chr09	24000000	24250000	250000	2x_LOP868_499	2.38691396882464
chr09	24000000	24500000	500000	2x_LOP868_435	2.38691396882464_2.32806810015645
chr09	24000000	24500000	500000	2x_LOP868_493	2.84639768254544_2.32806810015645
chr09	24750000	25000000	250000	2x_LOP868_289	1.54935530905589
chr09	25000000	25250000	250000	2x_LOP868_128	1.5705993366424
chr09	25000000	25250000	250000	2x_LOP868_259	1.5705993366424
chr09	26000000	26250000	250000	2x_LOP868_480	2.22615576911915
chr09	26750000	27000000	250000	2x_LOP868_480	2.23738684930459
chr09	27000000	27250000	250000	2x_LOP868_286	2.81125474973073
chr09	27750000	28000000	250000	2x_LOP868_493	2.32080830190929
chr09	28000000	28250000	250000	2x_LOP868_480	2.14586849275518
chr09	28750000	29000000	250000	2x_LOP868_042	3.87392582442104
chr09	28750000	29000000	250000	2x_LOP868_043	3.87392582442104
chr09	29250000	29500000	250000	2x_LOP868_045	2.57224166108525
chr09	29250000	29500000	250000	2x_LOP868_062	2.57224166108525
chr09	29250000	29500000	250000	2x_LOP868_224	2.57224166108525
chr09	29250000	29500000	250000	2x_LOP868_272	2.57224166108525
chr09	29250000	29500000	250000	2x_LOP868_278	2.57224166108525
chr09	29250000	29500000	250000	2x_LOP868_435	2.57224166108525
chr09	29250000	29500000	250000	2x_LOP868_493	2.98973652245032
chr09	29250000	29500000	250000	2x_LOP868_494	2.57224166108525
chr09	29250000	29500000	250000	2x_LOP868_499	2.57224166108525
chr09	29750000	30250000	500000	2x_LOP868_045	3.39400286963756_3.56925384139555
chr09	29750000	30250000	500000	2x_LOP868_062	3.39400286963756_3.25944913392652
chr09	29750000	30250000	500000	2x_LOP868_224	3.39400286963756_3.25944913392652
chr09	29750000	30250000	500000	2x_LOP868_272	3.39400286963756_3.25944913392652
chr09	29750000	30250000	500000	2x_LOP868_278	3.39400286963756_3.25944913392652
chr09	29750000	30250000	500000	2x_LOP868_435	3.39400286963756_3.56925384139555
chr09	29750000	30250000	500000	2x_LOP868_493	3.67383775078608_3.56925384139555
chr09	29750000	30250000	500000	2x_LOP868_494	3.39400286963756_3.56925384139555
chr09	29750000	30250000	500000	2x_LOP868_499	3.67383775078608_3.25944913392652
chr09	32250000	32500000	250000	2x_LOP868_258	1.61316323400797
chr09	32250000	32500000	250000	2x_LOP868_479	1.61316323400797
chr09	32500000	32750000	250000	2x_LOP868_247	2.18129801698945
chr09	32500000	32750000	250000	2x_LOP868_259	1.53534942933073
chr09	32750000	33000000	250000	2x_LOP868_278	2.23882287501033
chr09	32750000	33000000	250000	2x_LOP868_485	2.23882287501033
chr09	32750000	33000000	250000	2x_LOP868_494	2.23882287501033
chr09	32750000	33500000	750000	2x_LOP868_493	2.23882287501033_2.34867907045942_2.3911399390265
chr09	33250000	33500000	250000	2x_LOP868_045	2.24684464602956
chr09	34250000	34500000	250000	2x_LOP868_493	2.34181585636839
chr09	34500000	34750000	250000	2x_LOP868_295	2.39305087711181
chr09	35000000	35250000	250000	2x_LOP868_224	2.44997619210348
chr09	35000000	35500000	500000	2x_LOP868_045	2.44997619210348_2.37117332879259
chr09	35000000	35500000	500000	2x_LOP868_062	2.44997619210348_2.37117332879259
chr09	35000000	35500000	500000	2x_LOP868_272	2.44997619210348_2.37117332879259
chr09	35000000	35500000	500000	2x_LOP868_278	2.44997619210348_2.37117332879259
chr09	35000000	35500000	500000	2x_LOP868_435	2.44997619210348_2.37117332879259
chr09	35000000	35500000	500000	2x_LOP868_493	2.44997619210348_2.37117332879259
chr09	35000000	35500000	500000	2x_LOP868_499	2.44997619210348_2.37117332879259
chr09	37250000	37500000	250000	2x_LOP868_289	1.59596709977812
chr09	38250000	38500000	250000	2x_LOP868_090	2.28994704607386
chr09	38250000	38500000	250000	2x_LOP868_487	2.28994704607386
chr09	38500000	38750000	250000	2x_LOP868_480	2.1178706606954
chr09	38500000	38750000	250000	2x_LOP868_485	2.1178706606954
chr09	38500000	38750000	250000	2x_LOP868_493	2.25585522440203
chr09	39500000	39750000	250000	2x_LOP868_045	2.20104623856472
chr09	39500000	39750000	250000	2x_LOP868_062	2.20104623856472
chr09	39500000	39750000	250000	2x_LOP868_224	2.20104623856472
chr09	39500000	39750000	250000	2x_LOP868_272	2.20104623856472
chr09	39500000	39750000	250000	2x_LOP868_278	2.20104623856472
chr09	39500000	39750000	250000	2x_LOP868_435	2.40426012225872
chr09	39500000	39750000	250000	2x_LOP868_493	2.40426012225872
chr09	39500000	39750000	250000	2x_LOP868_494	2.20104623856472
chr09	39500000	39750000	250000	2x_LOP868_499	2.20104623856472
chr09	39750000	40000000	250000	2x_LOP868_485	2.22257934649252
chr09	40000000	41000000	1000000	2x_LOP868_493	2.38536041688732_2.50508191230429_2.43460913771051_3.51619994660415
chr09	40250000	40500000	250000	2x_LOP868_224	2.20618374181701
chr09	40250000	41000000	750000	2x_LOP868_045	2.20618374181701_2.13213951152711_3.13728328714102
chr09	40250000	41000000	750000	2x_LOP868_062	2.20618374181701_2.13213951152711_3.13728328714102
chr09	40250000	41000000	750000	2x_LOP868_435	2.20618374181701_2.13213951152711_3.13728328714102
chr09	40250000	41000000	750000	2x_LOP868_499	2.20618374181701_2.13213951152711_3.13728328714102
chr09	40500000	40750000	250000	2x_LOP868_485	2.13213951152711
chr09	40500000	41000000	500000	2x_LOP868_272	2.13213951152711_3.13728328714102
chr09	40500000	41000000	500000	2x_LOP868_278	2.13213951152711_3.13728328714102
chr09	40500000	41000000	500000	2x_LOP868_494	2.13213951152711_3.13728328714102
chr09	40750000	41000000	250000	2x_LOP868_224	3.13728328714102
chr09	41500000	41750000	250000	2x_LOP868_479	0.788423375111573
chr09	42000000	42250000	250000	2x_LOP868_493	2.28700454927873
chr09	45250000	45500000	250000	2x_LOP868_479	1.53667361801494
chr09	47500000	47750000	250000	2x_LOP868_480	1.73444901489106
chr09	48250000	48500000	250000	2x_LOP868_480	1.47668468233538
chr09	50000000	50250000	250000	2x_LOP868_465	2.28858860375071
chr09	53250000	53500000	250000	2x_LOP868_479	1.62577616513773
chr09	57000000	57250000	250000	2x_LOP868_005	1.64320109671099
chr09	57000000	57250000	250000	2x_LOP868_306	1.64320109671099
chr09	58250000	58500000	250000	2x_LOP868_268	1.76445587348793
chr09	59250000	59500000	250000	2x_LOP868_479	1.52976134474214
chr09	61500000	61540751	40751	2x_LOP868_281	13.0995051085848
chr09	61500000	61540751	40751	2x_LOP868_295	11.5587132052379
chr10	250000	500000	250000	2x_LOP868_480	1.68246653521061
chr10	250000	500000	250000	2x_LOP868_487	1.68246653521061
chr10	2250000	2500000	250000	2x_LOP868_480	1.62563648377034
chr10	3250000	3500000	250000	2x_LOP868_064	1.67951209832117
chr10	3250000	3500000	250000	2x_LOP868_433	1.67951209832117
chr10	3250000	3750000	500000	2x_LOP868_480	1.67951209832117_1.5293771302836
chr10	3750000	4000000	250000	2x_LOP868_479	1.54459182707544
chr10	4750000	5000000	250000	2x_LOP868_005	1.76625112316892
chr10	4750000	5000000	250000	2x_LOP868_401	1.76625112316892
chr10	4750000	5000000	250000	2x_LOP868_433	1.76625112316892
chr10	4750000	5000000	250000	2x_LOP868_479	1.76625112316892
chr10	4750000	5000000	250000	2x_LOP868_480	1.76625112316892
chr10	4750000	5000000	250000	2x_LOP868_487	1.76625112316892
chr10	6500000	6750000	250000	2x_LOP868_487	1.61330564135662
chr10	25500000	25750000	250000	2x_LOP868_480	2.45399409190407
chr10	31250000	31500000	250000	2x_LOP868_479	3.53911637462893
chr10	33500000	33750000	250000	2x_LOP868_480	2.69863375643719
chr10	36250000	36500000	250000	2x_LOP868_479	2.64260977670033
chr10	43750000	44000000	250000	2x_LOP868_480	1.57970629120538
chr10	46500000	46750000	250000	2x_LOP868_480	1.57704865339382
chr10	48250000	48500000	250000	2x_LOP868_480	1.48643370314356
chr10	50000000	50250000	250000	2x_LOP868_479	1.55771228711091
chr10	50250000	50500000	250000	2x_LOP868_295	2.35326309147104
chr10	55750000	56000000	250000	2x_LOP868_487	1.72417254468143
chr10	59750000	59756223	6223	2x_LOP868_289	36.1017044581891
chr10	59750000	59756223	6223	2x_LOP868_487	19.5768606441186
chr11	5750000	6000000	250000	2x_LOP868_479	1.58528708355958
chr11	5750000	6000000	250000	2x_LOP868_480	1.74662870842418
chr11	7500000	7750000	250000	2x_LOP868_090	2.54224466315637
chr11	7500000	7750000	250000	2x_LOP868_480	1.67090049881393
chr11	8000000	8250000	250000	2x_LOP868_034	1.65130526098616
chr11	8000000	8250000	250000	2x_LOP868_467	2.2807779705709
chr11	8000000	8250000	250000	2x_LOP868_469	2.2807779705709
chr11	8000000	8250000	250000	2x_LOP868_479	1.65130526098616
chr11	8000000	8250000	250000	2x_LOP868_480	1.65130526098616
chr11	8000000	8250000	250000	2x_LOP868_502	2.2807779705709
chr11	9750000	10000000	250000	2x_LOP868_365	1.68538034433753
chr11	9750000	10000000	250000	2x_LOP868_469	2.25020326375304
chr11	10000000	10250000	250000	2x_LOP868_027	2.3116287697546
chr11	10250000	10750000	500000	2x_LOP868_479	1.49836153025478_1.62134263776038
chr11	10500000	10750000	250000	2x_LOP868_454	1.62134263776038
chr11	11250000	11500000	250000	2x_LOP868_479	1.61453610773898
chr11	13750000	14000000	250000	2x_LOP868_299	2.42468903230929
chr11	13750000	14000000	250000	2x_LOP868_373	1.7978071886551
chr11	15750000	16000000	250000	2x_LOP868_479	2.16724996953349
chr11	18000000	18250000	250000	2x_LOP868_480	2.3961377086871
chr11	22250000	22500000	250000	2x_LOP868_474	1.43309057147477
chr11	22250000	22500000	250000	2x_LOP868_479	2.21521644575914
chr11	23250000	23500000	250000	2x_LOP868_480	2.84179633038371
chr11	26250000	26500000	250000	2x_LOP868_474	1.24848107311794
chr11	26750000	27250000	500000	2x_LOP868_479	2.20584071492239_2.19529739333653
chr11	27250000	27500000	250000	2x_LOP868_493	2.35056634880956
chr11	27500000	27750000	250000	2x_LOP868_479	2.50777999337048
chr11	29500000	29750000	250000	2x_LOP868_016	3.0477414098506
chr11	29500000	29750000	250000	2x_LOP868_308	1.26602357959789
chr11	29500000	29750000	250000	2x_LOP868_532	1.26602357959789
chr11	32500000	32750000	250000	2x_LOP868_289	3.02101647388766
chr11	33000000	33250000	250000	2x_LOP868_081	2.27842953286902
chr11	33000000	33250000	250000	2x_LOP868_387	2.27842953286902
chr11	33250000	33500000	250000	2x_LOP868_480	2.28526848049655
chr11	35250000	35500000	250000	2x_LOP868_480	2.34081223390992
chr11	36500000	36750000	250000	2x_LOP868_480	1.67097901672707
chr11	37250000	37500000	250000	2x_LOP868_065	1.44767191474139
chr11	37500000	37750000	250000	2x_LOP868_119	2.0110913526534
chr11	37500000	37750000	250000	2x_LOP868_480	1.33545268795122
chr11	38500000	38750000	250000	2x_LOP868_480	1.6405847147463
chr11	38750000	39000000	250000	2x_LOP868_299	2.3441911443748
chr11	38750000	39000000	250000	2x_LOP868_479	1.58945498026573
chr11	40000000	40250000	250000	2x_LOP868_480	1.62275944269736
chr11	41000000	41250000	250000	2x_LOP868_480	1.65068827938581
chr11	41500000	41750000	250000	2x_LOP868_480	1.72063810221887
chr11	43750000	44000000	250000	2x_LOP868_1160	2.40286395795761
chr11	44750000	45000000	250000	2x_LOP868_1160	2.74265719240708
chr11	45000000	45250000	250000	2x_LOP868_480	1.65592109937129
chr12	1000000	1250000	250000	2x_LOP868_479	1.79333419492236
chr12	3500000	3750000	250000	2x_LOP868_401	2.28131934361183
chr12	3750000	4000000	250000	2x_LOP868_450	2.45081865779432
chr12	4750000	5000000	250000	2x_LOP868_479	1.64448737342956
chr12	5250000	5500000	250000	2x_LOP868_479	1.69984384093614
chr12	5750000	6000000	250000	2x_LOP868_479	1.67103194659057
chr12	7500000	7750000	250000	2x_LOP868_487	4.10259934754932
chr12	9250000	9500000	250000	2x_LOP868_465	2.36474886545361
chr12	13000000	13250000	250000	2x_LOP868_004	2.62155901583403
chr12	13000000	13250000	250000	2x_LOP868_006	2.62155901583403
chr12	13000000	13250000	250000	2x_LOP868_027	2.62155901583403
chr12	13000000	13250000	250000	2x_LOP868_131	2.62155901583403
chr12	13000000	13250000	250000	2x_LOP868_538	2.62155901583403
chr12	13750000	14000000	250000	2x_LOP868_041	2.29549151634515
chr12	14250000	14750000	500000	2x_LOP868_480	2.80184270814241_2.6955076903029
chr12	15000000	15250000	250000	2x_LOP868_480	2.60018503737313
chr12	17250000	17500000	250000	2x_LOP868_480	2.7222845885205
chr12	18750000	19000000	250000	2x_LOP868_480	2.33995896198611
chr12	20250000	20500000	250000	2x_LOP868_480	1.51428669026181
chr12	21500000	21750000	250000	2x_LOP868_479	2.36752525511417
chr12	21500000	21750000	250000	2x_LOP868_522	2.26327899165955
chr12	23750000	24000000	250000	2x_LOP868_286	2.91833820384999
chr12	25250000	25500000	250000	2x_LOP868_480	2.48976495142143
chr12	25750000	26000000	250000	2x_LOP868_293	2.52802364165208
chr12	25750000	26000000	250000	2x_LOP868_480	2.52802364165208
chr12	26000000	26250000	250000	2x_LOP868_295	2.83499522466254
chr12	26250000	26500000	250000	2x_LOP868_286	2.26197294280995
chr12	27500000	27750000	250000	2x_LOP868_480	2.31656986605784
chr12	34250000	34500000	250000	2x_LOP868_480	2.61101770265646
chr12	36500000	37000000	500000	2x_LOP868_480	2.56580447402671_2.32240586397447
chr12	39000000	39250000	250000	2x_LOP868_286	2.32461847930962
chr12	41500000	41750000	250000	2x_LOP868_027	2.25700941684866
chr12	44500000	44750000	250000	2x_LOP868_480	2.55500432228964
chr12	46250000	46500000	250000	2x_LOP868_479	2.27783887868026
chr12	46500000	46750000	250000	2x_LOP868_004	2.15287903825859
chr12	46500000	46750000	250000	2x_LOP868_027	2.15287903825859
chr12	46500000	46750000	250000	2x_LOP868_043	2.15287903825859
chr12	46500000	46750000	250000	2x_LOP868_131	2.15287903825859
chr12	46500000	46750000	250000	2x_LOP868_480	2.15287903825859
chr12	46500000	46750000	250000	2x_LOP868_505	2.15287903825859
chr12	47000000	47250000	250000	2x_LOP868_456	1.48765846682098
chr12	47750000	48000000	250000	2x_LOP868_480	2.81707091767631
chr12	48750000	49000000	250000	2x_LOP868_480	1.69967570583197
chr12	51250000	51500000	250000	2x_LOP868_131	2.38178032104105
chr12	54250000	54500000	250000	2x_LOP868_480	1.44398270025461
chr12	55500000	55750000	250000	2x_LOP868_480	1.54298299204013
chr12	56500000	56750000	250000	2x_LOP868_289	1.63109413364089
chr12	56750000	57000000	250000	2x_LOP868_480	1.72347284031089
chr12	57000000	57250000	250000	2x_LOP868_289	1.72520250120159
chr12	57250000	57500000	250000	2x_LOP868_479	1.62277196433147
chr12	57250000	57500000	250000	2x_LOP868_480	1.52541297957153
chr12	58500000	58750000	250000	2x_LOP868_464	2.40499637195552
chr12	59000000	59250000	250000	2x_LOP868_363	1.69308882021065
chr12	59000000	59250000	250000	2x_LOP868_480	1.69308882021065
chr12	59500000	59750000	250000	2x_LOP868_425	1.65290944927442
